
   .------------------------------------.
   |                                    |
   |   | |/ /  _ _ _ ___ _ _| |_ ___    |
   |   | ' < || | '_/ -_) ' \  _/ _ \   |
   |   |_|\_\_,_|_| \___|_||_\__\___/   |
   |                                    |
   |            by dlf                  |
   |                                    |
   '------------------------------------'
       ${project.name}
       Version ${project.version}
